####################
#S##################
# #         0L29LL##
# # ### # ##########
#   #   #         ##
# ### #########R# ##
# #LL #       #K# ##
# ##### ##### ### ##
#   #       # #   ##
### # ##### # # # ##
#LR # #   # # # # ##
### # # # # # # # ##
#   #   # # #   # ##
# ####### ##########
#       # #       ##
##### # # # #####D##
#RLK# # #   #  7#L##
#R### # ##### #4#L##
#     #       #3#KE#
####################