####################
#S##################
# #               ##
# # ### # ##########
#   #   #         ##
# ### #########R# ##
# #LL #       #K# ##
# ##### ##### ### ##
#   #       # #   ##
### # ##### # # # ##
#LR # #   # # # # ##
### # # # # # # # ##
#   #   # # #   # ##
# ####### ##########
#       # #       ##
##### # # # #####D##
#RLK# # #   #   #L##
#R### # ##### # #L##
#     #       # #KE#
####################