#####################
#S###################
#     #           #L#
# ### # ####### # DK#
# #LD #       # #####
# ########### #     #
#     #K#   # ##### #
#####   #R# # DRLL# #
#   # ##### # ##### #
# #   # #   # #   # #
# ##### # # # # # # #
#         # #   # # #
#D#D##### # ##### #D#
#K#L#KL   #       #K#
###################E#
#####################